##########
#@.......#
#.########
#.......X#
##########