###############
#@....#.......#
###.#.#.#####.#
#...#.#.....#.#
#.###.###.#.#.#
#.....#...#.#.#
#####.#.###.#.#
#.....#.....#.#
#.#######.###.#
#.........#X..#
###############