#######################
#@..#.....#.........#.#
#..#X.#......######...#
#...#..##.#...#....##.#
#.#######.#.#.##.##...#
#.....#.#.#.#..#......#
#.#####.#.#.####.###..#
#.......#.#......#....#
#.#.################..#
#.#...#...............#
#.#####.###############
#.....................#
#######################